!SIL SIL
กระเป๋าตัง	kr a p aa w^ t a ng^
กระเป๋าเงิน	kr a p aa w^ ng q n^
กราฟ	kr aa f^
ของ	kh @@ ng^
ของฉัน	kh @@ ng^ ch a n^
ขึ้น	kh v n^
คริปโต	khr i p^ t oo
คอย	kh @ j^
ฉัน	ch a n^
ซูชิ	s uu ch i
ดอร์จคอย	d @@ t^ kh @@ j^
ดอลล่า	d @ n^ l a w^
ทั้งหมด	th a ng^ m o t^
ที่	th ii
บาท	b aa t^
บิทคอยน์	b i t^ kh @@ j^
บีทีซี	b ii th ii s ii
บีเอ็นบี	b ii z e n^ b ii
มาก	m aa k^
มากที่สุด	m aa k^ th ii s u t^
มาย	m aa j^
ยูเอสดอลล่าร์	j uu z ee t^ d @ n^ l aa
ยูเอสดีที	j uu z ee t^ s a d ii th ii
ราคา	r aa kh aa
ลง	l o ng^
ลิ้ง	l i ng^
วอลเล็ต	w @@ n^ l e t^
วันนี้	w a n^ n ii
สกุลไทย	s a k u n^ th a j^
สิบ	s i p^
สุด	s u t^
หมา	m aa
ออเดอร์	z @@ d qq
อะไร	z a r a j^
อันดับ	z a n^ d a p^
อีทีเฮช	z ii th ii h t^
อีเธอเรียม	z ii th qq r iia m^
เค้ก	kh ee k^
เงินบาท	ng q n^ b aa t^
เชนลิ้ง	ch ee n^ l i ng^
เท่าไหร่	th a w^ r a j^
เปลี่ยน	pl iia n^
เป็น	p e n^
เหรียญ	r iia n^
เอด้า	z ee d aa
เอ็กอาร์พี	z e k^ z aa ph ii
แบรนด์	b xx n^
แอลทีซี	z xx l^ th ii s ii
โกวาจี	k oo w aa c ii
โปรโตคอล	pr oo t oo kh @ n^
ไทยบาท	th a j^ b aa t^
ไบแนนซ์	b a j^ n xx n^ s
ไลท์คอยน์	l a j^ kh @@ j^
ไหน	n a j^
